


   		  		    				      
   		  		    				      
XX0000000000000000000000000000000000000000000000000000000000000000000000000XX   		  		    				      
XX0000000000000000000000000000000000000000000000000000000000000000000000000XX   		  		    				      
XX0000000000000000000000000000000000000000000000000000000000000000000000000XX   		  		    				      
XX0000000000000000000000000000000000000000000000000000000000000000000000000XX   		  		    				      
XX0000000000000000000000000000000000000000000000000000000000000000000000000XX   		  		    				      
XX0000000000000000000000000000000000000000000000000000000000000000000000000XX   		  		    				      
XX0000000000000000000000000000000000000000000000000000000000000000000000000XX   		  		    				      
XX0000000000000000000000000000000000000000000000000000000000000000000000000XX   		  		    				      
XX0000000000000000000000000000000C0000000000000000000000000C000000000000000XX   		  		    				      
XX00000000000000000000000000000XXXX000000000000000000000XXXX000000000000000XX
XX0000000000000000000000000000000000000XX0000000000000000000000000000000000XX 		  		    				      
XX0000000000000000000000000000000000000XX0000000000000000000000000000000000XX   		  		    				     
XXC000E00000000000000000000000000000000XX000000C00EE00000000000000000P000C0XX 		  		    				    					
XXXXXXXXXXXXXXXXXXOOOOOOXXXXXXOOOOOOXXXXXOOOOOXXXXXXXXXXXXXXXXXXXXXXXXXXXXXXX		
XXXXXXXXXXXXXXXXXXOOOOOOXXXXXXOOOOOOXXXXXOOOOOXXXXXXXXXXXXXXXXXXXXXXXXXXXXXXX          
                     
