
   	

  	
	    				      
XXXXXXXXXXXXXXX00000000000000000000000000000000000000000000000000000000000000000000000000XXXXXXXXXXXXXXX   		  		    				      
XXXXXXXXXXXXXXX00000000000000000000000000000000000000000000000000000000000000000000000000XXXXXXXXXXXXXXX   		  		    				      
XXXXXXXXXXXXXXX00000000000000000000000000000000000000000000000000000000ECC000000000000000XXXXXXXXXXXXXXX   		  		    				      
XXXXXXXXXXXXXXX0000000000000000000000000000000000000000000000000000000XXXXX00000000000000XXXXXXXXXXXXXXX   		  		    				      
XXXXXXXXXXXXXXX00000000000000000000000000000000000000000000000000000000000000000000000000XXXXXXXXXXXXXXX   		  		    				      
XXXXXXXXXXXXXXX0000000000000000000000000000000000000000000000000C000000000000000C00000000XXXXXXXXXXXXXXX   		  		    				      
XXXXXXXXXXXXXXX000000000000000000000000000000000000000000000000XXXX00000000000XXXX0000000XXXXXXXXXXXXXXX   		  		    				      
XXXXXXXXXXXXXXX00000000000000000000000000000000000000000000000000000000000000000000000000XXXXXXXXXXXXXXX   		  		    				      
XXXXXXXXXXXXXXX0000000000000000000000000000000EC0000000000000000000000000C000000000000000XXXXXXXXXXXXXXX   		  		    				      
XXXXXXXXXXXXXXX00000000000000000000000000000XXXXXX000000000000000X0000XXXXX00000000000000XXXXXXXXXXXXXXX
XXXXXXXXXXXXXXX0000000000000000000000000000000000000XX0000000000XX000000000000000000000C0XXXXXXXXXXXXXXX 		  		    				      
XXXXXXXXXXXXXXX0000000000000000000000000000000000000XX000000000XXX000000000000000000000C0XXXXXXXXXXXXXXX   		  		    				     
XXXXXXXXXXXXXXX0000000000CE00000000000000000000000C0XX000000C0XXXX0CECECE0000000000P000C0XXXXXXXXXXXXXXX 		  		    				    					
XXXXXXXXXXXXXXXXXXXXXXXXXXXXXXXOOOOOOXXXXXXOOOOOOXXXXXOOOOOXXXXXXXXXXXXXXXXXXXXXXXXXXXXXXXXXXXXXXXXXXXXX		
XXXXXXXXXXXXXXXXXXXXXXXXXXXXXXXOOOOOOXXXXXXOOOOOOXXXXXOOOOOXXXXXXXXXXXXXXXXXXXXXXXXXXXXXXXXXXXXXXXXXXXXX          
                     
